000000000000010000000000000101
111101110111010111011111110101
000101000100010001010000010100
010111011111111101010111010101
010000010000010001010001000001
011111110111010111011111111101
000000000001000001000000000101
011111111111011111111111010111
000100000001000100000001010001
011101111101110101111101110101
010001000101000101000000010101
110111010101111101011111011100
000101010100010001010001000001
011101010111010111110101011111
000100010000010000010101010000
010111111101110111010101110100
010000000100010101000100000100
111111110111010101111111111100
000100000101010001000100000101
010101111101011101011101110101
010101010001000101000001000101
010101010101110101011111010101
010001000101000101000100010100
010111011101011101011101111100
010101000101010101010001000000
011101110101010101110101011100
000001000100010000000101010101
111111011111111111111111010100
000000000000000000000000010001
010101111110101010000000000000
